77777777777777777777777777777777777777777IIIIIIIIIIIIIIIIIIIIIIIIIIIIIIIIIIIIIIIIIIIIIIIII
77777777777777777777777777777777777777777IIIIIIIIIIIIIIIIIIIIIIIIIIIIIIIIIIIIIIIIIIIIIIIII
77777777777777777777777777777777777777777IIIIIIIIIIIIIIIIIIIIIIIIIIIIIIIIIIIIIIIIIIIIIIIII
77777777777777777777777777777777777777777IIIIIIIIIIIIIIIII77777IIIIIIIIIIIIIIIIIIIIIIIIIII
77777777777777777777777777777777777777777IIIIIIIIIIIIIIIII77777IIIIIIIIIIIIIIIIIIIIIIIIIII
7777777eUUUUUUUd7777777777777777777777777IIIII777777777777777777IIIIIIIIIIIIIIIIIIIIIIIIII
7777777UUUUUUUUU77777777777777777@@@@@7777IIIH77777JJJJJ77777777IIIIIIIIIIIIIIIIIIIIIIIIII
7777777_UUUUUUUU77777777777777777@@@@@7777IHHHo7777JJJJJ77777777IIIIIIIIIIIIIIIIIIIIIIIIII
7777777777777UUU77777777777777777@@@@@77777HHHIo777JJJJJ77777777IIIIIIIIIIIIIIIIIIIIIIIIII
7777777777777_UUUUd77777777777777@@@@@77777HHHHHo77JJJJJ77777777IIIIIIIIIIIIIIIIIIIIIIIIII
777777777777777_UUUUd777777777777_UUUUd77777HHHHH7eUUUU^7777777IIIIIIIIIIIIIIIIIIIIIIIIIII
7777777777777777_UUUUUUUUUUUUUUUUUUUUUUUd7777eUHHUUUUU^7777777IIIIIIIIIIIIIIIIIIIIIIIIIIII
77777777777777777777_UUUUUUUUUUUUUUUUUUUUUUUUUUHHU^77777777777IIIIIIIIIIIIIIIIIIIIIIIIIIII
7777777777777777777777777777777777777777_UUUU^7IHooo777777777IIIIIIIIIIIIIIIIIIIIIIIIIIIII
77777777777777777777777777777777777777777_UU777IIIHHooooooooIIIIIIIIIIIIIIIIIIIIIIIIIIIIII
777777777777777777777777777777777777777777UU777IIIHHHHHHHHHIIIIIIIIIIIIIIIIIIIIIIIIIIIIIII
777777777777777777777777777777777777777777UU77777IIHHHHHHHHIIIIIIIIIIIIIIIIIIIIIIIIIIIIIII
777777777777777777777777777777777777777777UU77777777777777777IIIIIIIIIIIIIIIIIIIIIIIIIIIII
777777777777777777777777777777777777777777UU777777777777777777IIIIIIIIIIIIIIIIIIIIIIIIIIII
77777777777777777777777777777777777777777eUU777777777777777777IIIIIIIIIIIIIIIIIIIIIIIIIIII
7777777777777777777777777777777777777777UUUU777777777777777777IIIIIIIIIIIIIIIIIIIIIIIIIIII
7777777777777777777777777777777777777777UUUU777777744444444777IIIIIIIIIIIIIIIIIIIIIIIIIIII
777777777777777777777777777777777777777777UU7777777444444447777IIIIIIIIIIIIIIIIIIIIIIIIIII
777777777777777777777777777777777777777777UU7777777444444447777IIIIIIIIIIIIIIIIIIIIIIIIIII
777777777777777777777777777777777777777777UUd777777444444447777IIIIIIIIIIIIIIIIIIIIIIIIIII
777777777777777777777777777777777777777777UUUUUUUUd444444447777IIIIIIIIIIIIIIIIIIIIIIIIIII
777777777777777777777777777777777777777777UUUUUUUUU444444447777IIIIIIIIIIIIIIIIIIIIIIIIIII
7777777777777777777777777777777777777777eUUU^777_UU444444447777IIIIIIIIIIIIIIIIIIIIIIIIIII
77777777777777777777777777777777777777eUUUU^77777_UUUUUU^777777IIIIIIIIIIIIIIIIIIIIIIIIIII
7777777777777777777777777777777777eUUUUUUU^7777777_UUUU^7777777IIIIIIIIIIIIIIIIIIIIIIIIIII
777777777777777777777777777777UUUUUUUUU^77777777777777777777777IIIIIIIIIIIIIIIIIIIIIIIIIII
777777777777777777777777777777UUUUUUU^7777777777777777777777777IIIIIIIIIIIIIIIIIIIIIIIIIII
777777777777777777777777777777777777777777777777777777777777777IIIIIIIIIIIIIIIIIIIIIIIIIII
777777777777777777777777777777777777777777777777777777777777777IIIIIIIIIIIIIIIIIIIIIIIIIII
777777777777777777777777777777777777777777777777777777777777777IIIIIIIIIIIIIIIIIIIIIIIIIII
7777777777777777777777777777777777777777777777777777777777777777IIIIIIIIIIIIIIIIIIIIIIIIII
7777777777777777777777777777777777777777777777777777777777777777IIIIIIIIIIIIIIIIIIIIIIIIII
7777777777777777777777777777777777777777777777777777777777777777IIIIIIIIIIIIIIIIIIIIIIIIII
7777777777777777777777777777777777777777777777777777777777777777IIIIIIIIIIIIIIIIIIIIIIIIII
$
0 4 9 35 20 8
0 1 9 53 10 4
0 2 27 54 10 5
