TTTTTTTTTTTTTTTTTTTTTTTTTTTTTTTTTTTTTTTTTRRRRRRRRRRRRRRRRRRRRRRRRRRRRRRRRRRRRRRRRRRRRRRRRR
TTTTTTTTTTTTTTTTTTTTTTTTTTTTTTTTTTTTTTTTTRRRRRRRRRRRRRRRRRRRRRRRRRRRRRRRRRRRRRRRRRRRRRRRRR
TTTTTTTTTTTTTTTTTTTTTTTTTTTTTTTTTTTTTTTTRRRRRRRRRRRRRRRRRRRRRRRRRRRRRRRRRRRRRRRRRRRRRRRRRR
TTTTTTTTTTTTTTTTTTTTTTTTTTTTTRRRRTTTTTTTRRRRRRRRRRRRRRRRRRRRRRRRRRRRRRRRRRRRRRRRRRRRRRRRRR
TTTTTTTRRRRRRRRRRRRRRRRRRRRRRRRRRRRRRTTTRRRRRRRRRRRRRRRRRRRRRRRRRRRRRRRRRRRRRRRRRRRRRRRRRR
TTTTTTTRRRRRRRRRRRRRRRRRRRRRRRRRRRRRRRRRRRRRRRRRRRRRRRRRRRRRRRRRRRRRRRRRRRRRRRRRRRRRRRRRRR
TTTTTTTRRRRRRRRRRRRRRRRRRRRRRRRRRRRRRR[RRRRRRRRRRRRRRRRR[RRRRRRRRRRRRRRRRRRRRRRRRRRRRRRRRR
TTTTTTTTTTTTTRRRRRRRRRRRRRRRRRRRRRRRRR[RRRRRRRRRRRRRRRRR[RRRRRRRRRRRRRRRRRRRRRRRRRRRRRRRRR
TTTTTTTTTTTTTRRRRRRRRRRRRRRRRRRRR[[[[[[RRRRRRRRRRRR[[[[[[RRRRRRRRRRRRRRRRRRRRRRRRRRRRRRRRR
TTTTTTTTTTTTTTTRRRRRRRRRRRRRRRRRR[[[[[[RRRRTRRRRRRR[[[[[[RRRRRRRRRRRRRRRRRRRRRRRRRRRRRRRRR
TTTTTTTTTTTTTTTTRRRRRRRRRRRRRRRRR[[[[[[RRTRRRRRRRRR[[[[[[RRRRRRRRRRRRRRRRRRRRRRRRRRRRRRRRR
TTTTTTTTTTTTTTTTTTTRRRRRRRRRRRRRRRRRRRRRRRRRRRRRRRRRRRRRRRRRRRRRRRRRRRRRRRRRRRRRRRRRRRRRRR
TTTTTTTTTTTTTTTTTTTTTRRRRRRRRRRRRRRRRRRRRRRRRRRRRRRRRRRRRRRRRRRRRRRRRRRRRRRRRRRRRRRRRRRRRR
TTTTTTTTTTTTTTTTTTTTTRRRRRRRRRRRRRRRRRRRRRRRRRR[[RRRRRRRRRRRRRRRRRRRRRRRRRRRRRRRRRRRRRRRRR
TTTTTTTTTTTTTTTTTTTRRRRRRRRRRRRRRRRRRRRRRRRRRRRRRRRRRRRRRRRRRRRRRRRRRRRRRRRRRRRRRRRRRRRRRR
TTTTTTTTTTTTRRRRRRRRRRRRRRRRRRRRRRRRRRRRRRRRRRRRTRRRRRRRRRRRRRRRRRRRRRRRRRRRRRRRRRRRRRRRRR
TTTTTTTTTTTTTRRRRRRRRRRRRRRRRRRRRRRRRRRRR-RRRRRRRRRRTRRRRRRRRRRRRRRRRRRRRRRRRRRRRRRRRRRRRR
TTTTTTTTTTTRRRRRRRRRRRRRRRRRRRRRRRRRRRRRRRRRRRRRRRRRRRRRRRRRRRRRRRRRRRRRRRRRRRRRRRRRRRRRRR
TTTTTTTTTTTTTRRRRRRRRRRRRRRRRRRRRR`aRRRRRRRRRTRRR`aRRRRRRRRRRRRRRRRRRRRRRRRRRRRRRRRRRRRRRR
TTTTTTTTTTTTTTTTTTTRRRRRRRRRRRRRRRRRRRRRRRRRRRRRRRRRRRRRRRRRRRRRRRRRRRRRRRRRRRRRRRRRRRRRRR
TTTTTTTTTTTTTTTTTTRRRRRRRRRRRRRRRRRRRRRRRRRRRRR/.RRRRRRRRRRRRRRRRRRRRRRRRRRRRRRRRRRRRRRRRR
TTTTTTTTTTTTTTTTTRRRRRRRRRRRRRRRRRRRRRRRRRRRRRRRRRRRRRRRRRRRRRRRRRRRRRRRRRRRRRRRRRRRRRRRRR
TTTTTTTTTTTTTTTTTTTRRRRRRRRRRRRRRRRRRRRRRRRRRRRRRRRRRRRRRRRRRRRRRRRRRRRRRRRRRRRRRRRRRRRRRR
TTTTTTTTTTTTTTTTTTTRTTTRRRRRRRRRRRRRRRRRRRRRRRRRRRRRRRRRRRR[RRRRRRRRRRRRRRRRRRRRRRRRRRRRRR
TTTTTTTTTTTTTTTTTTTTTTTRTRRRRRRRRRRRRRRRRRRRRRRRRRRRRRRRRRR[RRRRRRRRRRRRRRRRRRRRRRRRRRRRRR
TTTTTTTTTTTTTTTTTTTTTTTTTRRRRRRRRRRRRRR`aRRRRRRRRRR[[[[[[[[[RRRRRRRRRRRRRRRRRRRRRRRRRRRRRR
TTTTTTTTTTTTTTTTTTTTTTTTTTTRRRRRRRRRRRRRRRRRRRRRRRR[[[[[[[[[RRRRRRRRRRRRRRRRRRRRRRRRRRRRRR
TTTTTTTTTTTTTTTTTTTTTTTRRRRRRRRRRRRRRTRRRRRRRRRRRRR[[[[[[[[[RRRRRRRRRRRRRRRRRRRRRRRRRRRRRR
TTTTTTTTTTTTTTTTTTTTTTTTTTTRRRRRRRRRRRRRRRRRRRRRRRR[[[[[[[[[RRRRRRRRRRRRRRRRRRRRRRRRRRRRRR
TTTTTTTTTTTTTTTTTTTTTTTTTTTRRRRRRRRRRRRRRRRRRRTRRRRRR+RRRRRRRRRRRRRRRRRRRRRRRRRRRRRRRRRRRR
TTTTTTTTTTTTTTTTTTTTTTTTTTTRRRRRRRRRRRRRRRRRRRRRRRRRRRRRRRRRRRRRRRRRRRRRRRRRRRRRRRRRRRRRRR
TTTTTTTTTTTTTTTTTTTTTTTTTTTRRRRRRRRRRRRRRRRRRRRRRRRRRRRRRRRRRRRRRRRRRRRRRRRRRRRRRRRRRRRRRR
TTTTTTTTTTTTTTTTTTTTTTTTTTTRRRRRRRRRRRRRRRRRRRRRRRRRRRRRRRRRRRRRRRRRRRRRRRRRRRRRRRRRRRRRRR
TTTTTTTTTTTTTTTTTTTTTTTTRRRRRRRRRRRRRRRRRRRRRRRRRRRRRRRRRRRRRRRRRRRRRRRRRRRRRRRRRRRRRRRRRR
TTTTTTTTTTTTTTTTTTTTTTTTRRRRRRTTTTTTTTTTTTTTTTTTTRRRRRRRRRRRRRRRRRRRRRRRRRRRRRRRRRRRRRRRRR
TTTTTTTTTTTTTTTTTTTTTTTTTTTTTTTTTTTTTTTTTTTTTTTTTTTTTTTTTTTRRRRRRRRRRRRRRRRRRRRRRRRRRRRRRR
TTTTTTTTTTTTTTTTTTTTTTTTTTTTTTTTTTTTTTTTTTTTTTTTTTTTTTTTTTTTTTTTRRRRRRRRRRRRRRRRRRRRRRRRRR
TTTTTTTTTTTTTTTTTTTTTTTTTTTTTTTTTTTTTTTTTTTTTTTTTTTTTTTTTTTTTTTTRRRRRRRRRRRRRRRRRRRRRRRRRR
RRRRRRRRRRRRRRRRRRRRRRRRRRRRRRRRRRRRRRRRRRRRRRRRRRRRRRRRRRRRRRRRRRRRRRRRRRRRRRRRRRRRRRRRRR
RRRRRRRRRRRRRRRRRRRRRRRRRRRRRRRRRRRRRRRRRRRRRRRRRRRRRRRRRRRRRRRRRRRRRRRRRRRRRRRRRRRRRRRRRR
RRRRRRRRRRRRRRRRRRRRRRRRRRRRRRRRRRRRRRRRRRRRRRRRRRRRRRRRRRRRRRRRRRRRRRRRRRRRRRRRRRRRRRRRRR
RRRRRRRRRRRRRRRRRRRRRRRRRRRRRRRRRRRRRRRRRRRRRRRRRRRRRRRRRRRRRRRRRRRRRRRRRRRRRRRRRRRRRRRRRR

