ZZZZZZZZZZZZZZZZZZZZZZZZZZZZZZZZZZZZZZZZZRRRRRRRRRRRRRRRRRRRRRRRRRRRRRRRRRRRRRRRRRRRRRRRRR
ZZZZZZZZZZZZZZZZZZZZZZZZZZZZZZZZZZZZZZZZZRRRRRRRRRRRRRRRRRRRRRRRRRRRRRRRRRRRRRRRRRRRRRRRRR
ZZZZZZZZZZZZZZZZZZZZZZZZZZZZZZZZZZZZZZZZZRRRRRRRRRRRRRRRRRRRRRRRRRRRRRRRRRRRRRRRRRRRRRRRRR
ZZZZZZZZZZZZZZZZZZZZZZZZZZZZZZZZZZZZZZZZRRRRRRRRRRRRRRRRRRRRRRRRRRRRRRRRRRRRRRRRRRRRRRRRRR
ZZZZZZZZZZZZZZZZZZZZZZZZZZZZZRRRRZZZZZZZRRRRRRRRRRRRRRRRRRRRR1RRRRRRRRRRRRRRRRRRRRRRRRRRRR
ZZZZZZZRRRRRRRRRRRRRRRRRRRRRRRRRRRRRRZZZRRRRRRRRRRRRRRRRRRRRRRRRRRRRRRRRRRRRRRRRRRRRRRRRRR
ZZZZZZZRRRRRRRRRRRRRR1RR1RRRRRRRRRRRRRRRRRRRRRRRRRRRRRRRRRRR8RRRRRRRRRRRRRRRRRRRRRRRRRRRRR
ZZZZZZZRRRRRRRRRRRRRRRRRRRRRRR12RRRRRRRRRRRRRRRR2RRRRRRRRR8RRRRRRRRRRRRRRRRRRRRRRRRRRRRRRR
ZZZZZZZZZZZZZRRRRRRRRRRRRRRRRRRRRRRRRRRR<RRRRRRRRRRRRRR\RRR8RRRRRRRRRRRRRRRRRRRRRRRRRRRRRR
ZZZZZZZZZZZZZRRRRRRRRRRRRR1RRRRRRRR:?RRRR3RRRRRRRRRR?:0\R1RRRRRRRRRRRRRRRRRRRRRRRRRRRRRRRR
ZZZZZZZZZZZZZZZRRRRRRRRRRRRRRRRRRRRRRRRR1RRZRRRRRRRRRRRRRR2RRRRRRRRRRRRRRRRRRRRRRRRRRRRRRR
ZZZZZZZZZZZZZZZZRRRRRRRRRRRRRRRRRRRRRRRRRZRRRRlmmnRRRRRRR2RRRRRRRRRRRRRRRRRRRRRRRRRRRRRRRR
ZZZZZZZZZZZZZZZZZZZRRRRRRRRRRRRRRRRRRRRRRRRRRRrsstRRRRRRRRRRRRRRRRRRRRRRRRRRRRRRRRRRRRRRRR
ZZZZZZZZZZZZZZZZZZZZZRRRRRRRRRRR1RRRRR1RRRRRRRRRRRRRRR8RRRRRRRRRRRRRRRRRRRRRRRRRRRRRRRRRRR
ZZZZZZZZZZZZZZZZZZZZZRRRRR8RRRRRRRR1RRRRRRRRRRRRRRRRRRRRRRRRRRRRRRRRRRRRRRRRRRRRRRRRRRRRRR
ZZZZZZZZZZZZZZZZZZZRRRRRRRRRRRRRRRRRRRRRRRRRRR1RRRRRRRRRRRRRRRRRRRRRRRRRRRRRRRRRRRRRRRRRRR
ZZZZZZZZZZZZRRRRRRRRRRR8R1RRRRR8RRRR2RRRRRRR1RRRZRRRRRRRRRRRRRRRRRRRRRRRRRRRRRRRRRRRRRRRRR
ZZZZZZZZZZZZZRRRRR1RRR8RRRRRRRRRRRRRRRRRRRRRRRRRRRRRZRRRRRRRRRRRRRRRRRRRRRRRRRRRRRRRRRRRRR
ZZZZZZZZZZZRRRRRRRRRRRRRRRRRRRR2RRRR6R1RRRRRRRR2RRRRRR8RR1RRRRRRRRRRRRRRRRRRRRRRRRRRRRRRRR
ZZZZZZZZZZZZZRRRRRRRRRRRRR1RRRRRR<fgRRRRRRRRRZRRRfgR8RRRRRRRRRRRRRRRRRRRRRRRRRRRRRRRRRRRRR
ZZZZZZZZZZZZZZZZZZZRR1RRRRRRRRRRRRRc]cRRRRRRRRRR32RRRRRR2RR8RRRRRRRRRRRRRRRRRRRRRRRRRRRRRR
ZZZZZZZZZZZZZZZZZZRRRRRRRRRRRRRRRRRcRRRRRRRRRRRRRRRRRRRRRRRRRRRRRRRRRRRRRRRRRRRRRRRRRRRRRR
ZZZZZZZZZZZZZZZZZRRRRRRRRRRRRRR2R6RRRR<RRRRRRRR1RRRRRRRRRRRRRRRRRRRRRRRRRRRRRRRRRRRRRRRRRR
ZZZZZZZZZZZZZZZZZZZRRRRRRRRR8RRRRR1RRR1RRRRR<RRRRRRRRRRRRRRR1RRRRRRRRRRRRRRRRRRRRRRRRRRRRR
ZZZZZZZZZZZZZZZZZZZRZZZRRRRRRRRRRRRRRRRRRRRRRRRRRRRRRRRRRRRRRRRRRRRRRRRRRRRRRRRRRRRRRRRRRR
ZZZZZZZZZZZZZZZZZZZZZZZRZRRRRRRRRRRR2RRRRRRRRRRRRRRRRRRRRRRRRRRRRRRRRRRRRRRRRRRRRRRRRRRRRR
ZZZZZZZZZZZZZZZZZZZZZZZZZRRRRRRRRRRRRRRfgRRRRRRRRRRRR0R0RRRRR2RRRRRRRRRRRRRRRRRRRRRRRRRRRR
ZZZZZZZZZZZZZZZZZZZZZZZZZZZRRR8RRR3RRRRRRRRRRRRRRRRRRRY?RRRRRRRRRRRRRRRRRRRRRRRRRRRRRRRRRR
ZZZZZZZZZZZZZZZZZZZZZZZRRRRRRRRRRRRRRZRRRRRRRRR2RRRRRRRRRRRRRRRRRRRRRRRRRRRRRRRRRRRRRRRRRR
ZZZZZZZZZZZZZZZZZZZZZZZZZZZR8RRRRRRRRRRRRRRRRRRRRRRRRRRRRRRR8RRRRRRRRRRRRRRRRRRRRRRRRRRRRR
ZZZZZZZZZZZZZZZZZZZZZZZZZZZRRRRRRRRRRRRRRRR8RRZRRRRRRRRR1RRR1RRRRRRRRRRRRRRRRRRRRRRRRRRRRR
ZZZZZZZZZZZZZZZZZZZZZZZZZZZRRRRRRRRRRRRRR1RRR2RRRRRRRRRRRRRRRRRRRRRRRRRRRRRRRRRRRRRRRRRRRR
ZZZZZZZZZZZZZZZZZZZZZZZZZZZRRRRRRRRRRRR2RRRRRRRR1RRRRR82RRRRRRRRRRRRRRRRRRRRRRRRRRRRRRRRRR
ZZZZZZZZZZZZZZZZZZZZZZZZZZZ2RRR8RR1RRR2RRR8RRRRRRRRR2RRRRRRR8RRRRRRRRRRRRRRRRRRRRRRRRRRRRR
ZZZZZZZZZZZZZZZZZZZZZZZZRRRRRRRRRRRRRRRRRRRRRRRRRRRRRRRR1RRRRRRRRRRRRRRRRRRRRRRRRRRRRRRRRR
ZZZZZZZZZZZZZZZZZZZZZZZZRRRRRRZZZZZZZZZZZZZZZZZZZRRRRRRRRRRRRRRRRRRRRRRRRRRRRRRRRRRRRRRRRR
ZZZZZZZZZZZZZZZZZZZZZZZZZZZZZZZZZZZZZZZZZZZZZZZZZZZZZZZZZZZRRRRRRRRRRRRRRRRRRRRRRRRRRRRRRR
ZZZZZZZZZZZZZZZZZZZZZZZZZZZZZZZZZZZZZZZZZZZZZZZZZZZZZZZZZZZZZZZZRRRRRRRRRRRRRRRRRRRRRRRRRR
ZZZZZZZZZZZZZZZZZZZZZZZZZZZZZZZZZZZZZZZZZZZZZZZZZZZZZZZZZZZZZZZZRRRRRRRRRRRRRRRRRRRRRRRRRR
RRRRRRRRRRRRRRRRRRRRRRRRRRRRRRRRRRRRRRRRRRRRRRRRRRRRRRRRRRRRRRRRRRRRRRRRRRRRRRRRRRRRRRRRRR
RRRRRRRRRRRRRRRRRRRRRRRRRRRRRRRRRRRRRRRRRRRRRRRRRRRRRRRRRRRRRRRRRRRRRRRRRRRRRRRRRRRRRRRRRR
RRRRRRRRRRRRRRRRRRRRRRRRRRRRRRRRRRRRRRRRRRRRRRRRRRRRRRRRRRRRRRRRRRRRRRRRRRRRRRRRRRRRRRRRRR

