JNNNNNNNNJ
JLLLLLLLLJ
JLLLLLLLLJ
JLLLLLLLLJ
JLLLLLLLLJ
JLLLLLLLLJ
JLLLLLLLKJ
JLLLLLLLLJ
JLLLLLLLLJ
NNNNNNNNNN
$
0 0 10 4 10 53
0 2 6 8 5 10
